1,1,1,1,1,1,1,1
1,0,4,4,4,4,4,1
1,4,4,4,4,4,4,1
1,4,2,4,3,4,4,1
1,4,4,4,4,4,4,1
1,4,4,4,4,4,4,1
1,1,4,1,1,1,1,1